222222222222222222222222222222222222222222222222222222222222
233333333333333333333333333333333333333333333333333333333332
230000000000000000000000000000000000000000000000000000000032
230000000000000000000000000000000000000000000000000000000032
230000000000000000000000000000000000000000000000000000000032
230000000000000000000000000000000000000000000000000000000032
230000000000000000000000000000000000000000000000000000000032
230000000000000000000000000000000000000000000000000000000032
230000000000000000000000000000000000000000000000000000000032
230000000000000000000000000000000000000000000000000000000032
230000000000000000000000000000000000000000000000000000000032
230000000000000000000000000000000000000000000000000000000032
230000000000000000000000000000000000000000000000000000000032
230000000000000000000000000000000000000000000000000000000032
230000000000000000000000000000000000000000000000000000000032
230000000000000000000000000000000000000000000000000000000032
230000000000000000000000000000000000000000000000000000000032
230000000000000000000000000000000000000000000000000000000032
230000000000000000000000000000000000000000000000000000000032
230000000000000000000000000000000000000000000000000000000032
230000000000000000000000000000000000000000000000000000000032
230000000000000000000000000000000000000000000000000000000032
230000000000000000000000000000000000000000000000000000000032
230000000000000000000000000000000000000000000000000000000032
230000000000000000000000000000000000000000000000000000000032
230000000000000000000000000000000000000000000000000000000032
230000000000000000000000000000000000000000000000000000000032
230000000000000000000000000000000000000000000000000000000032
230000000000000000000000000000000000000000000000000000000032
230000000000000000000000000000000000000000000000000000000032
230000000000000000000000000000000000000000000000000000000032
230000000000000000000000000000000000000000000000000000000032
230000000000000000000000000000000000000000000000000000000032
230000000000000000000000000000000000000000000000000000000032
230000000000000000000000000000000000000000000000000000000032
230000000000000000000000000000000000000000000000000000000032
230000000000000000000000000000000000000000000000000000000032
233333333333333333333333333333333333333333333333333333333332
222222222222222222222222222222222222222222222222222222222222
