110000000000000000000000000000000000000000000000000000000011
100000000000000000000000000000000000000000000000000000000001
110000000000000000000000000000000000000000000000000000000011
110000000000000000000000000000000000000000000000000000000011
110000000000000000000000000000000000000000000000000000000011
110000000000000000000000000000000000000000000000000000000011
110000000000000000000000000000000000000000000000000000000011
110000000000000000000000000000000000000000000000000000000011
110000000000000000000000000000000000000000000000000000000011
110000000000000000000000000000000000000000000000000000000011
110000000000000000000000000000000000000000000000000000000011
110000000000000000000000000000000000000000000000000000000011
110000000000000000000000000000000000000000000000000000000011
110000000000000000000000000000000000000000000000000000000011
110000000000000000000000000010000000000000000000000000000011
110000000000000000000000000000000000000000000000000000000011
110000000000000000000000000000000000000000000000000000000011
110000000000000000000000000000000000000000000000000000000011
110000000000000000000000000000000000000000000000000000000011
110000000000000000000000000000000000000000000000000000000011
110000000000000000000000000000000000000000000000000000000011
110000000000000000000000000000000000000000000000000000000011
110000000000000000000000000000000000000000000000000000000011
110000000000000000000000000000000000000000000000000000000011
110000000000000000000000000000000000000000000000000000000011
110000000000000000000000000000000000000000000000000000000011
110000000000000000000000000000000000000000000000000000000011
110000000000000000000000000000000000000000000000000000000011
110000000000000000000000000000000000000000000000000000000011
110000000000000000000000000000000000000000000000000000000011
110000000000000000000000000000000000000000000000000000000011
110000000000000000000000000000000000000000000000000000000011
110000000000000000000000000000000000000000000000000000000011
110000000000000000000000000000000000000000000000000000000011
110000000000000000000000000000000000000000000000000000000011
110000000000000000000000000000000000000000000000000000000011
110000000000000000000000000000000000000000000000000000000011
100000000000000000000000000000000000000000000000000000000001
110000000000000000000000000000000000000000000000000000000011