222222222222222222222222222222222222222222222222222222222222
233333333333333333333333333333333333333333333333333333333332
230000000000000000000000000000000000000000000000000000000032
230000000000000000000000000000000000000000000000000000000032
230000000000000000000000000000000000000000000000000000000032
230000000000000000000000000000000000000000000000000000000032
230000000000000000000000000000000000000000000000000000000032
230000000000000000000000000000000000000000000000000000000032
230000000000000000000000000000000000000000000000000000000032
230000000000000000000000000000000000000000000000000000000032
230000000000000000000000000000000000000000000000000000000032
230000000000000000000000000000000000000000000000000000000032
230000000000000000000000000000000000000000000000000000000032
230000000000000000000000000000000000000000000000000000000032
230000000000000000000000000000000000000000000000000000000032
230000000000000000000000000000000000000000000000000000000032
230000000000000000000000000000000000000000000000000000000032
230000000000000000000000000000000000000000000000000000000032
230000000000000000000000000000000000000000000000000000000032
230000000000000000000000000000000000000000000000000000000032
230000000000111111111111111111111111000000000000000000000032
231111111111100000000000100000000001111111111111111111111132
230000000000000000000000100000000000000000000000000000000032
230000000000000000000000100000000000000000000000000000000032
230000000000000000000000100000000000000000000000000000000032
230000000000000000000000111111111111111000000000000000000032
230000000000000000000000000000000000001000000000000000000032
230000000000000000000000000000000000001000000000000000000032
230000000000000000000000000000000000001000000000000000000032
230000000000000000000000000000000000001111110000111111111132
230000000000000000000000000000000000000000000000000000000032
230000000000000000000000000000000000000000000000000000000032
230000000000000000000000000000000000000000000000000000000032
230000000000000000000000000000000000000000000000000000000032
230000000000000000000000000000000000000000000000000000000032
230000000000000000000000000000000000000000000000000000000032
230000000000000000000000000000000000000000000000000000000032
233333333333333333333333333333333333333333333333333333333332
222222222222222222222222222222222222222222222222222222222222
