220111000101101100100100010011000000000000011100000000000022
210100000001101100000001101000100111000100000111000000000022
221001001000010100001001010010010010010000011000000000000022
221000001100000010001100110000100000101010010000000000000022
220001011001101000000101001001000111000010000000000000000022
220001011010101001000000000000000000010001000100100000000022
220010000000001000000001000000001000000000000001000000000022
220000100000000101000100010100000001000001000000001000000022
220000000100000000000000000000001000000000010000000000000022
220000000000000010010000000001001000000000000010000000000022
220000000000010000000000000010000000000000000000000000000022
220001010001000001000000000000000010010000000000000000000022
220100010000000000000000000100010001000000000010000100000022
220000000000000000000000000000010001010000001000000000000022
220000010001000000000000000010000000000000000000000100000022
220010000000000000000000000001000000000001000000000000000022
220001000000001000000000000000000000010000000000010000000022
220000000000000000000000010000000000000000000000001000000022
220000000000000000000000000000000000001000000000000001000022
220000010001000000000000000000000000001000000000000010000022
220000000000010000000000000000000000000000000000000001000022
220000010000000000000000000000001000000000001000000000000022
220000001000000001000000000000000000000000000000000000000022
220000001000000000000000001000000000000010000000000000000022
220000000000000000000000000000000000001000000000000000000022
220001000000000000000000000000000000000000000001000000000022
220000000000000001000000000000001000000000000000000000000022
220000000001000000000000000000000000000000000000000000000022
220000000000000000000000000000000000000000000000000010000022
220000000000000000000000000010000000000000000000000000000022
220000000000000000000000000000000000000000000000001000000022
220001000000000000001000000000000000000000000000000000000022
220000000000000000000000000000000000000000000000000000000022
220000000000000000000000000000000000000000001000000000000022
220001000000001000000000000000000000000000000000000000000022
220000000000000000000000000000000001000000000000000000000022
220000001000000000000000000000000000000000000000000000000022
200000000000000000000000000000000000000000000000000000000002
220000000000000000000000000000000000000000000000000000000022
