222222222222222222222222222222222222222222222222222222222222
233333333333333333333333333333333333333333333333333333333332
230000000000000000000000000000000000000000000000000000000032
230000000000000000000000000000000000000000000000000000000032
230000000000000000000000000000000000000000000000000000000032
230000000000000000000000000000000000000000000000000000000032
230000000000000000000000000000000000000000000000000000000032
230000000000000000000000000000000000000000000000000000000032
230000000000000000000000000000000000000000000000000000000032
230000000000000000000000000000000000000000000000000000000032
230000000000000000000000000000000000000000000000000000000032
230000000000000000000000000000000000000000000000000000000032
230000000000000000000000000000000000000000000000000000000032
230000000000000000000000000000000000000000000000000000000032
230000000000000000000000000000000000000000000000000000000032
230000000000000000000000000000000000000000000000000000000032
230000000000000000000000000000000000000000000000000000000032
230000000000000000000000000000000000000000000000000000000032
230000000000000000000000000000000000000000000000000000000032
230000000000000000000000000000000000000000000000000000000032
230000000000111114111111111111411111000000000000000000000032
231111111111100000000000100000000001111111111111114111111132
230000000000000000000000100000000000000000000000000000000032
230000000000000000000000400000000000000000000000000000000032
230000000000000000000000100000000000000000000000000000000032
230000000000000000000011111111411111111000000000000000000032
230000000000000000000000100100000000001000000000000000000032
230000000000000000000000111100000000001000000000000000000032
230000000000000000000000000000000000001000000000000000000032
230000000000000000000000000000000000001111111111141111111132
230000000000000000000000000000000000000000000000000000000032
230000000000000000000000000000000000000000000000000000000032
230000000000000000000000000000000000000000000000000000000032
230000000000000000000000000000000000000000000000000000000032
230000000000000000000000000000000000000000000000000000000032
230000000000000000000000000000000000000000000000000000000032
230000000000000000000000000000000000000000000000000000000032
233333333333333333333333333333333333333333333333333333333332
222222222222222222222222222222222222222222222222222222222222
